Киев	Киеве	1
Киевская обл.	Киевской обл.	0
Винница	Виннице	0
Днепропетровск	Днепропетровске	0
Днепропетровская обл.	Днепропетровской обл.	0
Донецк	Донецке	0
Житомир	Житомире	0
Житомирская обл.	Житомирской обл.	0
Запорожье	Запорожье	0
Ивано-Франковск	Ивано-Франковске	0
Кировоград	Кировограде	0
Луганск	Луганске	0
Луцк	Луцке	0
Львов	Львове	1
Николаев	Николаеве	0
Одесса	Одессе	1
Одесская обл.	Одесской обл.	0
Полтава	Полтаве	0
Ровно	Ровно	0
Симферополь	Симферополе	1
Сумы	Суммах	0
Тернополь	Тернополе	0
Ужгород	Ужгороде	0
Харьков	Харькове	1
Херсон	Херсоне	0
Хмельницкий	Хмельницком	0
Черкассы	Черкассах	0
Чернигов	Чернигове	0
Черновцы	Черновцах	0
Винницкая обл.	Винницкой обл.	0
Волынская обл.	Волынской обл.	0
Донецкая обл.	Донецкой обл.	0
Закарпатская обл.	Закарпатской обл.	0
Запорожская обл.	Запорожской обл.	0
Ивано-Франковская обл.	Ивано-Франковской обл.	0
Кировоградская обл.	Кировоградской обл.	0
Крым	Крыму	1
Луганская обл.	Луганской обл.	0
Львовская обл.	Львовской обл.	0
Николаевская обл.	Николаевской обл.	0
Полтавская обл.	Полтавской обл.	0
Ровенская обл.	Ровенской обл.	0
Сумская обл.	Сумской обл.	0
Тернопольская обл.	Тернопольской обл.	0
Харьковская обл.	Харьковской обл.	0
Херсонская обл.	Херсонской обл.	0
Хмельницкая обл.	Хмельницкой обл.	0
Черкасская обл.	Черкасской обл.	0
Черниговская обл.	Черниговская обл.	0
Черновицкая обл.	Черновицкой обл.	0